razonablemente===razonablemente;
sobremanera===sobremanera;
extrañamente===extrañamente;
sustancialmente===sustancialmente;
exactamente===exactamente;
amistosamente===amistosamente;
literalmente===literalmente;
dentro===dentro;
junto===junto;
claramente===claramente;
rápidamente===rápidamente;
agradablemente===agradablemente;
prominentemente===prominentemente;
tristemente===tristemente;
teocráticamente===teocráticamente;
yuso===yuso;
expresamente===expresamente;
lisonjeramente===lisonjeramente;
singularmente===singularmente;
innegablemente===innegablemente;
sabiamente===sabiamente;
idénticamente===idénticamente;
tajantemente===tajantemente;
abundantemente===abundantemente;
consigo===consigo;
brutalmente===brutalmente;
sorprendentemente===sorprendentemente;
morfológicamente===morfológicamente;
aborreciblemente===aborreciblemente;
animalmente===animalmente;
irresistiblemente===irresistiblemente;
nuclearmente===nuclearmente;
encima===encima;
característicamente===característicamente;
quedo===quedo;
costosamente===costosamente;
fuertemente===fuertemente;
alegremente===alegremente;
regocijadamente===regocijadamente;
abominablemente===abominablemente;
bajamente===bajamente;
algo===algo;
líricamente===líricamente;
cuidadosamente===cuidadosamente;
independientemente===independientemente;
germánicamente===germánicamente;
pomposamente===pomposamente;
indisputablemente===indisputablemente;
poéticamente===poéticamente;
afeminadamente===afeminadamente;
fructíferamente===fructíferamente;
acabadamente===acabadamente;
personalmente===personalmente;
confiadamente===confiadamente;
cuasi===cuasi;
pacíficamente===pacíficamente;
abruptamente===abruptamente;
convenientemente===convenientemente;
anteayer===anteayer;
calladamente===calladamente;
inmensamente===inmensamente;
enfrente===enfrente;
impuramente===impuramente;
masivamente===masivamente;
acatadamente===acatadamente;
enérgicamente===enérgicamente;
formalmente===formalmente;
generalmente===generalmente;
físicamente===físicamente;
originalmente===originalmente;
enfáticamente===enfáticamente;
inocentemente===inocentemente;
alli===alli;
proféticamente===proféticamente;
lealmente===lealmente;
sensualmente===sensualmente;
misteriosamente===misteriosamente;
extrínsecamente===extrínsecamente;
quedito===quedito;
ásperamente===ásperamente;
recíprocamente===recíprocamente;
totalmente===totalmente;
genéricamente===genéricamente;
antiguamente===antiguamente;
lentamente===lentamente;
dogmáticamente===dogmáticamente;
sencillamente===sencillamente;
ciertamente===ciertamente;
inflexiblemente===inflexiblemente;
excelentemente===excelentemente;
hipotéticamente===hipotéticamente;
alocadamente===alocadamente;
aparte===aparte;
incesantemente===incesantemente;
incondicionalmente===incondicionalmente;
potencialmente===potencialmente;
nomás===nomás;
glacialmente===glacialmente;
implícitamente===implícitamente;
segundariamente===segundariamente;
apropiadamente===apropiadamente;
sindicalmente===sindicalmente;
oralmente===oralmente;
mancomún===mancomún;
fervorosamente===fervorosamente;
repetidamente===repetidamente;
afortunadamente===afortunadamente;
ávidamente===ávidamente;
firmemente===firmemente;
mecánicamente===mecánicamente;
airadamente===airadamente;
intuitivamente===intuitivamente;
verdaderamente===verdaderamente;
anteanoche===anteanoche;
irónicamente===irónicamente;
eventualmente===eventualmente;
hondo===hondo;
vehementemente===vehementemente;
espantosamente===espantosamente;
solamente===solamente;
ambiciosamente===ambiciosamente;
blasfemamente===blasfemamente;
doquier===doquier;
privativamente===privativamente;
consistentemente===consistentemente;
portentosamente===portentosamente;
cerca===cerca;
gratis===gratis;
anoche===anoche;
sentimentalmente===sentimentalmente;
jamás===jamás;
ventosamente===ventosamente;
familiarmente===familiarmente;
humanamente===humanamente;
musicalmente===musicalmente;
allá===allá;
basicamente===basicamente;
adelantadamente===adelantadamente;
fogosamente===fogosamente;
rígidamente===rígidamente;
inexorablemente===inexorablemente;
allí===allí;
meticulosamente===meticulosamente;
intelectualmente===intelectualmente;
académicamente===académicamente;
últimamente===últimamente;
honradamente===honradamente;
reflexivamente===reflexivamente;
lamentablemente===lamentablemente;
sanguinariamente===sanguinariamente;
químicamente===químicamente;
sinfónicamente===sinfónicamente;
disculpándose===disculpándose;
aproximadamente===aproximadamente;
aún===aún;
afectuosamente===afectuosamente;
remotamente===remotamente;
biológicamente===biológicamente;
concienzudamente===concienzudamente;
empero===empero;
paralelamente===paralelamente;
infamemente===infamemente;
temporalmente===temporalmente;
judicialmente===judicialmente;
inteligentemente===inteligentemente;
drásticamente===drásticamente;
caóticamente===caóticamente;
boquiabierta===boquiabierta;
celosamente===celosamente;
secundariamente===secundariamente;
trágicamente===trágicamente;
satisfactoriamente===satisfactoriamente;
arrogantemente===arrogantemente;
demonios===demonios;
diametralmente===diametralmente;
inicialmente===inicialmente;
vaginalmente===vaginalmente;
fatal===fatal;
fortuitamente===fortuitamente;
negligentemente===negligentemente;
fundamentalmente===fundamentalmente;
devotamente===devotamente;
categóricamente===categóricamente;
parcialmente===parcialmente;
mucho===mucho;
adónde===adónde;
separadamente===separadamente;
cruelmente===cruelmente;
exclusivamente===exclusivamente;
acústicamente===acústicamente;
demasiado===demasiado;
contrariamente===contrariamente;
informalmente===informalmente;
íntegramente===íntegramente;
instantáneamente===instantáneamente;
definitivamente===definitivamente;
profundamente===profundamente;
ciegamente===ciegamente;
imperfectamente===imperfectamente;
realmente===realmente;
alias===alias;
sistemáticamente===sistemáticamente;
casualmente===casualmente;
dignamente===dignamente;
afablemente===afablemente;
considerablemente===considerablemente;
violentamente===violentamente;
públicamente===públicamente;
fraudulentamente===fraudulentamente;
finamente===finamente;
adagio===adagio;
sarcásticamente===sarcásticamente;
notablemente===notablemente;
después===después;
vacuamente===vacuamente;
temprano===temprano;
básicamente===básicamente;
idealmente===idealmente;
ganosamente===ganosamente;
metódicamente===metódicamente;
suavemente===suavemente;
esponjosamente===esponjosamente;
jurídicamente===jurídicamente;
amorosamente===amorosamente;
ahora===ahora;agora;
detalladamente===detalladamente;
increíblemente===increíblemente;
ilimitadamente===ilimitadamente;
conmigo===conmigo;
levemente===levemente;
geográficamente===geográficamente;
suntuosamente===suntuosamente;
compulsivamente===compulsivamente;
aquende===aquende;
sociológicamente===sociológicamente;
asimismo===asimismo;
acertadamente===acertadamente;
aprisa===aprisa;
secretamente===secretamente;
abdominalmente===abdominalmente;
quirúrgicamente===quirúrgicamente;
raramente===raramente;
preventivamente===preventivamente;
directamente===directamente;
confortablemente===confortablemente;
requetebién===requetebién;
electrónicamente===electrónicamente;
relativamente===relativamente;
rudamente===rudamente;
adondequiera===adondequiera;
primero===primero;
como===como;
simbólicamente===simbólicamente;
generosamente===generosamente;
distraídamente===distraídamente;
intencionalmente===intencionalmente;
amigablemente===amigablemente;
milagrosamente===milagrosamente;
tempestuosamente===tempestuosamente;
tranquilamente===tranquilamente;
perfectamente===perfectamente;
mediados===mediados;
dónde===dónde;
corruptamente===corruptamente;
indirectamente===indirectamente;
moralmente===moralmente;
inexplicablemente===inexplicablemente;
superfluamente===superfluamente;
detenidamente===detenidamente;
cansadamente===cansadamente;
didácticamente===didácticamente;
abstractivamente===abstractivamente;
caro===caro;
humildemente===humildemente;
ostensiblemente===ostensiblemente;
brevemente===brevemente;
rápido===rápido;
abrumadoramente===abrumadoramente;
equivalentemente===equivalentemente;
jubilosamente===jubilosamente;
meramente===meramente;
lógicamente===lógicamente;
eternamente===eternamente;
condicionalmente===condicionalmente;
explícitamente===explícitamente;
previamente===previamente;
injustamente===injustamente;
religiosamente===religiosamente;
fonéticamente===fonéticamente;
altruistamente===altruistamente;
monstruosamente===monstruosamente;
casi===casi;
irracionalmente===irracionalmente;
perfeccionismo===perfeccionismo;
ahorita===ahorita;
usualmente===usualmente;
genéticamente===genéticamente;
antes===antes;
pronto===pronto;
felizmente===felizmente;
acaloradamente===acaloradamente;
paulatinamente===paulatinamente;
cordialmente===cordialmente;
acaso===acaso;
aquí===aquí;
experimentalmente===experimentalmente;
desvergonzadamente===desvergonzadamente;
maliciosamente===maliciosamente;
eficazmente===eficazmente;
establemente===establemente;
activamente===activamente;
cansinamente===cansinamente;
vagamente===vagamente;
saludablemente===saludablemente;
aparentemente===aparentemente;
verbigracia===verbigracia;
obviamente===obviamente;
comercialmente===comercialmente;
holgadamente===holgadamente;
silenciosamente===silenciosamente;
seriamente===seriamente;
farmacéuticamente===farmacéuticamente;
fisiológicamente===fisiológicamente;
póstumamente===póstumamente;
defensivamente===defensivamente;
rotundamente===rotundamente;
fluidamente===fluidamente;
solemnemente===solemnemente;
juntamente===juntamente;
solo===solo;
filológicamente===filológicamente;
abemoladamente===abemoladamente;
deprisa===deprisa;
consecutivamente===consecutivamente;
impacientemente===impacientemente;
fieramente===fieramente;
materialmente===materialmente;
mañana===mañana;
glotonamente===glotonamente;
majestuosamente===majestuosamente;
arriba===arriba;
apasionadamente===apasionadamente;
útilmente===útilmente;
tremendamente===tremendamente;
igualmente===igualmente;
tímidamente===tímidamente;
episódicamente===episódicamente;
eléctricamente===eléctricamente;
aqui===aqui;
animadamente===animadamente;
fructuosamente===fructuosamente;
improbablemente===improbablemente;
sensiblemente===sensiblemente;
previsiblemente===previsiblemente;
remilgadamente===remilgadamente;
ventajosamente===ventajosamente;
análogamente===análogamente;
técnicamente===técnicamente;
abstinente===abstinente;
oficialmente===oficialmente;
económicamente===económicamente;
siquiera===siquiera;
mentalmente===mentalmente;
ene===ene;
melancólicamente===melancólicamente;
atrás===atrás;
bajo===bajo;
enigmáticamente===enigmáticamente;
longitudinalmente===longitudinalmente;
temporariamente===temporariamente;
fotosintéticamente===fotosintéticamente;
groseramente===groseramente;
mustiamente===mustiamente;
dichosamente===dichosamente;
fácilmente===fácilmente;
diferentemente===diferentemente;
equivocadamente===equivocadamente;
aceptablemente===aceptablemente;
acullá===acullá;
anticipadamente===anticipadamente;
débilmente===débilmente;
variablemente===variablemente;
indudablemente===indudablemente;
imparcialmente===imparcialmente;
sintéticamente===sintéticamente;
inusualmente===inusualmente;
diagonalmente===diagonalmente;
galanamente===galanamente;
ágilmente===ágilmente;
recientemente===recientemente;
corrompidamente===corrompidamente;
insípidamente===insípidamente;
consecuentemente===consecuentemente;
medio===medio;
abundadamente===abundadamente;
perpetuamente===perpetuamente;
vocalmente===vocalmente;
inexcusablemente===inexcusablemente;
incompletamente===incompletamente;
entresemana===entresemana;
indefinidamente===indefinidamente;
únicamente===únicamente;
socráticamente===socráticamente;
abstinentemente===abstinentemente;
presto===presto;
hurtadillas===hurtadillas;
telepáticamente===telepáticamente;
estoicamente===estoicamente;
pipa===pipa;
preternaturalmente===preternaturalmente;
lateralmente===lateralmente;
imperceptiblemente===imperceptiblemente;
nacionalmente===nacionalmente;
desapasionadamente===desapasionadamente;
teóricamente===teóricamente;
severamente===severamente;
completamente===completamente;
acérrimamente===acérrimamente;
genialmente===genialmente;
estúpidamente===estúpidamente;
garridamente===garridamente;
conscientemente===conscientemente;
vívidamente===vívidamente;
neciamente===neciamente;
pusilanimemente===pusilanimemente;
locamente===locamente;
adrede===adrede;
textualmente===textualmente;
total===total;
además===además;
involuntariamente===involuntariamente;
ligeramente===ligeramente;
menos===menos;
retrospectivamente===retrospectivamente;
seguidamente===seguidamente;
satíricamente===satíricamente;
sardónicamente===sardónicamente;
frágilmente===frágilmente;
pontificalmente===pontificalmente;
absurdamente===absurdamente;
intrínsecamente===intrínsecamente;
incidentalmente===incidentalmente;
asintóticamente===asintóticamente;
precisamente===precisamente;
constitucionalmente===constitucionalmente;
voluntariamente===voluntariamente;
estupendamente===estupendamente;
mutuamente===mutuamente;
inequívocamente===inequívocamente;
infortunadamente===infortunadamente;
progresivamente===progresivamente;
positivamente===positivamente;
he===he;
maquinalmente===maquinalmente;
adicionalmente===adicionalmente;
escasamente===escasamente;
invisiblemente===invisiblemente;
unanimidad===unanimidad;
autocráticamente===autocráticamente;
administrativamente===administrativamente;
colmadamente===colmadamente;
mejor===mejor;
sangrientamente===sangrientamente;
cronológicamente===cronológicamente;
expresivamente===expresivamente;
confidentemente===confidentemente;
horriblemente===horriblemente;
radicalmente===radicalmente;
respetuosamente===respetuosamente;
fetén===fetén;
equilibradamente===equilibradamente;
terriblemente===terriblemente;
fortunadamente===fortunadamente;
estrepitosamente===estrepitosamente;
imprudentemente===imprudentemente;
ahi===ahi;
presencialmente===presencialmente;
tácticamente===tácticamente;
do===do;
atentamente===atentamente;
mal===mal;
mensualmente===mensualmente;
resueltamente===resueltamente;
antenoche===antenoche;
abundosamente===abundosamente;
democráticamente===democráticamente;
propositivamente===propositivamente;
artísticamente===artísticamente;
fijamente===fijamente;
desigualmente===desigualmente;
impunemente===impunemente;
mayoritariamente===mayoritariamente;
ricamente===ricamente;
analógicamente===analógicamente;
flexiblemente===flexiblemente;
inconstitucionalmente===inconstitucionalmente;
alternativamente===alternativamente;
agraciadamente===agraciadamente;
inseparablemente===inseparablemente;
manualmente===manualmente;
tiránicamente===tiránicamente;
socialmente===socialmente;
falsamente===falsamente;
pavorosamente===pavorosamente;
sentenciosamente===sentenciosamente;
gigánticamente===gigánticamente;
principalmente===principalmente;
funestamente===funestamente;
eficientemente===eficientemente;
simbióticamente===simbióticamente;
majaderamente===majaderamente;
ahoritita===ahoritita;
mayormente===mayormente;
racionalmente===racionalmente;
legítimamente===legítimamente;
regularmente===regularmente;
elegantemente===elegantemente;
figurativamente===figurativamente;
abnegadamente===abnegadamente;
maridablemente===maridablemente;
quizás===quizás;
también===también;
justo===justo;
garbosamente===garbosamente;
particularmente===particularmente;
fotográficamente===fotográficamente;
salvajemente===salvajemente;
discretamente===discretamente;
enteramente===enteramente;
maduramente===maduramente;
entredientes===entredientes;
geológicamente===geológicamente;
alfabéticamente===alfabéticamente;
agresivamente===agresivamente;
simultáneamente===simultáneamente;
preservativamente===preservativamente;
automáticamente===automáticamente;
anormalmente===anormalmente;
quemarropa===quemarropa;
geométricamente===geométricamente;
verticalmente===verticalmente;
sabiendas===sabiendas;
actualmente===actualmente;
ardientemente===ardientemente;
abatidamente===abatidamente;
habitualmente===habitualmente;
ahí===ahí;
ignominiosamente===ignominiosamente;
metafóricamente===metafóricamente;
heroicamente===heroicamente;
postreramente===postreramente;
más===más;
judaicamente===judaicamente;
precavidamente===precavidamente;
interesadamente===interesadamente;
esencialmente===esencialmente;
preparatoriamente===preparatoriamente;
malditamente===malditamente;
presumiblemente===presumiblemente;
fielmente===fielmente;
encantadoramente===encantadoramente;
empíricamente===empíricamente;
ampliamente===ampliamente;
abdicativamente===abdicativamente;
galán===galán;
prematuramente===prematuramente;
jodidamente===jodidamente;
todavía===todavía;
cuando===cuando;quando;
posteriormente===posteriormente;
justamente===justamente;
viceversa===viceversa;
linealmente===linealmente;
trabajosamente===trabajosamente;
accidentalmente===accidentalmente;
no===no;
concisamente===concisamente;
maravillosamente===maravillosamente;
filosóficamente===filosóficamente;
enseguida===enseguida;
gramaticalmente===gramaticalmente;
sumamente===sumamente;
continuamente===continuamente;
afuera===afuera;
confidencialmente===confidencialmente;
fríamente===fríamente;
inclusive===inclusive;
importantemente===importantemente;
malvadamente===malvadamente;
históricamente===históricamente;
instintivamente===instintivamente;
ruidosamente===ruidosamente;
tecnológicamente===tecnológicamente;
abaldonadamente===abaldonadamente;
cuánto===cuánto;
salvo===salvo;
arbitrariamente===arbitrariamente;
próximamente===próximamente;
gitanamente===gitanamente;
gratuitamente===gratuitamente;
visualmente===visualmente;
unánimemente===unánimemente;
inaceptablemente===inaceptablemente;
exquisitamente===exquisitamente;
inteligiblemente===inteligiblemente;
pacientemente===pacientemente;
corporalmente===corporalmente;
accidentariamente===accidentariamente;
internacionalmente===internacionalmente;
donde===donde;
cantidades===cantidades;
abiertamente===abiertamente;
creativamente===creativamente;
cínicamente===cínicamente;
crónicamente===crónicamente;
científicamente===científicamente;
analíticamente===analíticamente;
magistralmente===magistralmente;
súbito===súbito;
extraordinariamente===extraordinariamente;
políticamente===políticamente;
esquemáticamente===esquemáticamente;
cabizbajamente===cabizbajamente;
venerablemente===venerablemente;
abrasadamente===abrasadamente;
ayer===ayer;
juguetonamente===juguetonamente;
estéticamente===estéticamente;
evidentemente===evidentemente;
adelante===adelante;
patéticamente===patéticamente;
dizque===dizque;
siempre===siempre;
furiosamente===furiosamente;
fugazmente===fugazmente;
intransitivamente===intransitivamente;
pundonorosamente===pundonorosamente;
máxime===máxime;
efectivamente===efectivamente;
cíclicamente===cíclicamente;
supuestamente===supuestamente;
adecuadamente===adecuadamente;adequadamente;
extensivamente===extensivamente;
anualmente===anualmente;
poco===poco;
frecuentemente===frecuentemente;freqüentemente;
morbosamente===morbosamente;
electoralmente===electoralmente;
agriamente===agriamente;
gravitacionalmente===gravitacionalmente;
espiralmente===espiralmente;
allende===allende;
retroactivamente===retroactivamente;
gallardamente===gallardamente;
peligrosamente===peligrosamente;
estratégicamente===estratégicamente;
inmediatamente===inmediatamente;
simétricamente===simétricamente;
mundialmente===mundialmente;
espontáneamente===espontáneamente;
fabulosamente===fabulosamente;
inesperadamente===inesperadamente;
vigorosamente===vigorosamente;
porfiadamente===porfiadamente;
virtualmente===virtualmente;
urgentemente===urgentemente;
mansamente===mansamente;
fóbicamente===fóbicamente;
presuntamente===presuntamente;
prudencialmente===prudencialmente;
específicamente===específicamente;
fraternalmente===fraternalmente;
quizá===quizá;
plenamente===plenamente;
psicológicamente===psicológicamente;
momentáneamente===momentáneamente;
hondamente===hondamente;
horizontalmente===horizontalmente;
oportunamente===oportunamente;
irritablemente===irritablemente;
constantemente===constantemente;
recio===recio;
debidamente===debidamente;
secamente===secamente;
desafortunadamente===desafortunadamente;
medicinalmente===medicinalmente;
exitosamente===exitosamente;
sacrílegamente===sacrílegamente;
deliberadamente===deliberadamente;
preferiblemente===preferiblemente;
cotidianamente===cotidianamente;
funcionalmente===funcionalmente;
abusivamente===abusivamente;
arrebatadoramente===arrebatadoramente;
vulgarmente===vulgarmente;
telefónicamente===telefónicamente;
prodigiosamente===prodigiosamente;
valientemente===valientemente;
inútilmente===inútilmente;
galantemente===galantemente;
críticamente===críticamente;
sedentariamente===sedentariamente;
irregularmente===irregularmente;
legalmente===legalmente;
coloquialmente===coloquialmente;
hoy===hoy;
ocasionalmente===ocasionalmente;
divertidamente===divertidamente;
furtivamente===furtivamente;
adentro===adentro;
ilegalmente===ilegalmente;
mientras===mientras;
delicadamente===delicadamente;
católicamente===católicamente;
anatómicamente===anatómicamente;
simplemente===simplemente;
manifestamente===manifestamente;
noblemente===noblemente;
nunca===nunca;
emocionalmente===emocionalmente;
tarde===tarde;
pobremente===pobremente;
incoherentemente===incoherentemente;
prácticamente===prácticamente;
subrepticiamente===subrepticiamente;
orgullosamente===orgullosamente;
tiernamente===tiernamente;
francamente===francamente;
escrupulosamente===escrupulosamente;
dolorosamente===dolorosamente;
correctamente===correctamente;
monótonamente===monótonamente;
xerográficamente===xerográficamente;
extremadamente===extremadamente;
ojalá===ojalá;
adonde===adonde;
ayuso===ayuso;
semanalmente===semanalmente;
gloriosamente===gloriosamente;
desdeñosamente===desdeñosamente;
dondequiera===dondequiera;
respectivamente===respectivamente;
infructuosamente===infructuosamente;
sinceramente===sinceramente;
profesionalmente===profesionalmente;
anteriormente===anteriormente;
especialmente===especialmente;
atropelladamente===atropelladamente;
perpendicularmente===perpendicularmente;
victoriosamente===victoriosamente;
libremente===libremente;
lícitamente===lícitamente;
anónimamente===anónimamente;
erróneamente===erróneamente;
su===su;
moderadamente===moderadamente;
superficialmente===superficialmente;
favorablemente===favorablemente;
ambiguamente===ambiguamente;
primeramente===primeramente;
hermosamente===hermosamente;
honestamente===honestamente;
entretanto===entretanto;
posiblemente===posiblemente;
sólo===sólo;
miserablemente===miserablemente;
cómicamente===cómicamente;
negativamente===negativamente;
deshonestamente===deshonestamente;
hace===hace;
sucintamente===sucintamente;
bastante===bastante;
etcétera===etcétera;
seguramente===seguramente;
estrechamente===estrechamente;
permanentemente===permanentemente;
abigarradamente===abigarradamente;
luego===luego;
visiblemente===visiblemente;
patológicamente===patológicamente;
ulteriormente===ulteriormente;
minuciosamente===minuciosamente;
naturalmente===naturalmente;
marrullero===marrullero;
innecesariamente===innecesariamente;
temáticamente===temáticamente;
dulcemente===dulcemente;
extensamente===extensamente;
porfa===porfa;
desgraciadamente===desgraciadamente;
imposiblemente===imposiblemente;
mancomunadamente===mancomunadamente;
excesivamente===excesivamente;
cuanto===cuanto;quanto;
antisépticamente===antisépticamente;
guay===guay;
verbalmente===verbalmente;
suficientemente===suficientemente;
despacio===despacio;
termodinámicamente===termodinámicamente;
extremamente===extremamente;
desventajosamente===desventajosamente;
muy===muy;
nerviosamente===nerviosamente;
sexualmente===sexualmente;
lejos===lejos;
semejantemente===semejantemente;
esporádicamente===esporádicamente;
prudentemente===prudentemente;
reiteradamente===reiteradamente;
gráficamente===gráficamente;
cuan===cuan;
caleta===caleta;
llanamente===llanamente;
potentemente===potentemente;
irremediablemente===irremediablemente;
cooperativamente===cooperativamente;
dramáticamente===dramáticamente;
fuera===fuera;
fijo===fijo;
incluso===incluso;
virtuosamente===virtuosamente;
inciertamente===inciertamente;
sádicamente===sádicamente;
infinitamente===infinitamente;
sagazmente===sagazmente;
antecedentemente===antecedentemente;
significativamente===significativamente;
asi===asi;
extraoficialmente===extraoficialmente;
cuándo===cuándo;quándo;
apenas===apenas;
tan===tan;
altamente===altamente;
abreviadamente===abreviadamente;
loablemente===loablemente;
apáticamente===apáticamente;
anticonstitucionalmente===anticonstitucionalmente;
qué===qué;
talvez===talvez;
cuernos===cuernos;
diariamente===diariamente;
contigo===contigo;
debajo===debajo;
comúnmente===comúnmente;
trascartón===trascartón;
transitivamente===transitivamente;
difícilmente===difícilmente;
alegóricamente===alegóricamente;
espiritualmente===espiritualmente;
estrictamente===estrictamente;
típicamente===típicamente;
tempestivamente===tempestivamente;
detrás===detrás;
acerca===acerca;
inevitablemente===inevitablemente;
aburridamente===aburridamente;
abés===abés;
nuevamente===nuevamente;
vigilantemente===vigilantemente;
gentilmente===gentilmente;
sigilosamente===sigilosamente;
densamente===densamente;
sicológicamente===sicológicamente;
desesperadamente===desesperadamente;
abajo===abajo;
claro===claro;
tampoco===tampoco;
aristocráticamente===aristocráticamente;
tardíamente===tardíamente;
bien===bien;
artificialmente===artificialmente;
hostilmente===hostilmente;
tozudamente===tozudamente;
periódicamente===periódicamente;
descaradamente===descaradamente;
necesariamente===necesariamente;
accesoriamente===accesoriamente;
vanamente===vanamente;
íntimamente===íntimamente;
estadísticamente===estadísticamente;
culturalmente===culturalmente;
amargamente===amargamente;
ecológicamente===ecológicamente;
sucesivamente===sucesivamente;
tradicionalmente===tradicionalmente;
ininterrumpidamente===ininterrumpidamente;
sediciosamente===sediciosamente;
abismalmente===abismalmente;
ordinariamente===ordinariamente;
amablemente===amablemente;
así===así;
demás===demás;
exageradamente===exageradamente;
fluentemente===fluentemente;
finalmente===finalmente;
corrientemente===corrientemente;
incorrectamente===incorrectamente;
fantásticamente===fantásticamente;
objetivamente===objetivamente;
recién===recién;
tangencialmente===tangencialmente;
infielmente===infielmente;
universalmente===universalmente;
emblemáticamente===emblemáticamente;
intensamente===intensamente;
probablemente===probablemente;
hábilmente===hábilmente;
fehacientemente===fehacientemente;
bruscamente===bruscamente;
jovialmente===jovialmente;
anchamente===anchamente;
jocosamente===jocosamente;
absolutamente===absolutamente;
ya===ya;
tácitamente===tácitamente;
dinámicamente===dinámicamente;
dudosamente===dudosamente;
aun===aun;
gradualmente===gradualmente;
honorablemente===honorablemente;
irreparablemente===irreparablemente;
matemáticamente===matemáticamente;
médicamente===médicamente;
